..............................
..............................
..............................
..............................
..............................
..............................
..............................
..............................
..........*...................
.......########...............
.......########...###.......*.
...*...########...###......&&&&
&&&&&&&########...###..&&..&&&&
&&&&&&&########@@@###@@&&@@&&&&
