..............................
..............................
..............................
..............................
..............................
..............................
..............................
..............................
........*.....................
.......########....*..........
.......########...###.......*.
......%########...###...*..&&&&
&&&&&&&########...###..&&..&&&&
&&&&&&&########@@@###@@&&@@&&&&