..............................
..............................
..............................
..............................
..............................
..............................
..............................
..............................
..........*...................
.......########....*..........
.......########...###.......*.
......%########...###......&&&&
&&&&&&&########...###..&&..&&&&
&&&&&&&########@@@###@@&&@@&&&&
